9
TTTTTTTTT
TOOOOOOFT
TOOTOTTOT
TOTOOOOOT
TOOOTTOOT
TOTOTOOTT
TOTOOTOOT
TOOOOOTOT
TTTTTTTTT